NO textures/brickplaster.xpm
SO textures/brickplaster.xpm
WE textures/003_height.xpm
EA textures/003_height.xpm
F 184,134,39
C 51,198,227
111111111111111111111111111111
100000000000000000000000000001
111111111100000000000000000001
100000101000000000000000000001
100000000000001111111111100001
100000000000001         100001
100000000000001         100001
100000000000001         111111
100000000000001
100000000000001
100000000000001
100000000000001
100110E00100001
111111111111111