NO textures/white_wall.xpm
SO textures/white_wall.xpm
WE textures/003_height.xpm
EA textures/003_height.xpm

F 68,68,68
C 51,198,227

           111111111111111111
           101110000011111111
           101100000111000001
           100100000000001001
10110000011100000000000010001
10000000001100000111011110001
11110111111111011100000010001
11110111011111011101010010111
11000000110101011100111010001
10000000000000001100101001001
10100000000000001100111000001
110000001101   00000000111111
111101111101   00000000000001
100000000011   00100001010001
100000000000   00000000001001
1110000000100N010000000001011
10000000000101000000000001111
11001110000101111001010110011
11111111111111111111111111111