NO textures/white_wall.xpm
SO textures/white_wall.xpm
WE textures/003_height.xpm
EA textures/003_height.xpm

F 68,68,68
C 51,198,227

11111111111111101111111111111
10111000001111111111110111011
10110000011100000000000010001
10010000000000100000000010111
10110000011100000000000010001
10000000001100000111011110001
11110111111111011100000010001
11110111011111011101010010111
11000000110101011100111010001
10000000000000001100101001001
10100000000000001100111000001
11000000110101000000000111111
11110111110101000000000000000
10000000001100000100001010001
10000000000000000000000001001
0110000000100N010000000001011
10000000000101000000000001111
11001110000101111001010110011
11111111111111011111111111111