NO textures/wall_1.xpm
SO textures/wall_2.xpm
WE textures/wall_3.xpm
EA textures/wall_4.xpm
F 184,134,39
C 51,198,227
11111111111111111111111111111
10111000001111111111110011011
10110000011100000000000010001
10010000000000100000000010111
10110000011100000000000010001
10000000001100000111011110001
11110111111111011100000010001
11110111111111011101010010111
11000000110101011100111010001
10000000000000001100101001001
10100000000000001100111000001
11000000110101000000000011111
11110111110101000000000000001
10000000001100000100000010001
10000000000000000000000001001
11100000001000010000000001011
10000000000101000000N00001111
11001110000101111001010110011
11111111111111111111111111111